WWWWWWWWWWWWWWWWWWWW
WGGGGGGGGGGGGGGGGGGW
WGHGGGGGGGGGGGGGGGGW
WGGGGGGGGGGGGGGGGGGW
WGGGGGGGGGGGGGGGGGGW
WGGGGGGGGGGGGGGGGGGW
WGGGGGGGGGGGGGGGGGGW
WGGGGGGGGGGGGGGGGGGW
WGGGGGGGCCCGGGGGGGGW
WGGGGGGGCCCGGGGGGGGW
WGGGGGGGCCCGGGGGGGGW
WGGGGGGGGGGGGGGGGGGW
WGGGGGGGGGGGGGGGGGGW
WGGGGGGGGGGGGGGGGGGW
WGGGGGGGGGGGGGGGGGGW
WGGGGGGGGGGGGGGGGGGW
WGGGGGGGGGGGGGGGGGGW
WGGGGGGGGGGGGGGGGGGW
WZZZZZZZZZZZZZZZZZZW
WWWWWWWWWWWWWWWWWWWW