WWWWWWWWWWWWWWWWWWWW
W................S.W
W.H..............S.W
W.H..............S.W
W.H..............S.W
W.H..............S.W
W.H..............S.W
W.H..............S.W
W.H.....CCC......S.W
W.H.....CCC......S.W
W.H.....CCC......S.W
W.H..............S.W
W.H..............S.W
W.H..............S.W
W.H..............S.W
W.H..............S.W
W.H..............S.W
W.H..............S.W
WZZZZZZZZZZZZZZZZZZW
WWWWWWWWWWWWWWWWWWWW