GGGGGGGGGGGG
GHHGGGGGGZGG
GGGGGGGGGGGG
GGGGWGGGGGGG
GGGGWGGGGGGG
GGGGWGGGGGGG
GGGGGGGGGGGG
GGGSSGGGGGGG
GGGGGGGGGGGG
GGGGGGGGXGGG
GGGGGGGGGGGG
GGGGGGGGGGGG