WWWWWWWWWWWWWWWWWWWW
W........W.........W
W..H.....W....S....W
W........W.........W
W........W.........W
W........W.........W
W........W.........W
W........W.........W
W....AAA.W.AAA.....W
W....A...W...A.....W
W....AAA.W.AAA.....W
W........W.........W
W........W....X....W
W........W.........W
W........W.........W
W........W.........W
W........W.........W
W........W.........W
WZZZZZZZZWZZZZZZZZZW
WWWWWWWWWWWWWWWWWWWW