ZZZZZZZZZZZZZZZZZZZZ
ZGGGGGGGGGGGGGGGGGGZ
ZGGGGGGGGGGGGGGGGGGZ
ZGGGGGGGGGGGGGGGGGGZ
ZGGGGGGGGGGGGGGGGGGZ
ZGGGGGGGGGGGGGGGGGGZ
ZGGGGGGSSSSSSGGGGGGZ
ZGGGGGGSHHHHSGGGGGGZ
ZGGGGGGSHXHHSGGGGGGZ
ZGGGGGGSHHHHSGGGGGGZ
ZGGGGGGSSSSSSGGGGGGZ
ZGGGGGGGGGGGGGGGGGGZ
ZGGGGGGGGGGGGGGGGGGZ
ZGGGGGGGGGGGGGGGGGGZ
ZGGGGGGGGGGGGGGGGGGZ
ZGGGGGGGGGGGGGGGGGGZ
ZGGGGGGGGGGGGGGGGGGZ
ZGGGGGGGGGGGGGGGGGGZ
ZGGGGGGGGGGGGGGGGGGZ
ZZZZZZZZZZZZZZZZZZZZ