WWWWWWWWWWWWWWWWWWWW
WZ..A....W....A..S.W
W..A.Z...W...Z.A...W
W....AAA.W.AAA.....W
W..H.....W.....X...W
W........W.........W
WAAAAA...W...AAAAA.W
W.....A..W..A......W
W..Z..A.CCC.A..Z...W
W.....A.CCC.A......W
WAAAAA...W...AAAAA.W
W........W.........W
W...S....W....H....W
W....AAA.W.AAA.....W
W..Z.....W.....Z...W
W..A.Z...W...Z.A...W
WZ..A....W....A..S.W
W........W.........W
WZZZZZZZZWZZZZZZZZZW
WWWWWWWWWWWWWWWWWWWW